NO ./Textures/xpm/egypt/egypt_wall_north.xpm
WE ./Textures/xpm/egypt/egypt_wall_east.xpm
SO ./Textures/xpm/egypt/egypt_wall_north.xpm
EA ./Textures/xpm/egypt/egypt_wall_east.xpm

C 249,207,103
F 150,75, 0

        1111111111111111111111111
        100D000000110000000000001
        1011000001110000000000001
        1001000000D00000000000001
111111111011000001110000000000001
10000000001100000111D11111D111111
1111D111111111D11100000010001
11110111111111011101010010001
11000000110101011000000010001
10000000000000001001010010001
1000000000000000D000000010001
10000000000000001001010010001
11000001110101011011011110N0111
11110111 1110101 101111010001
11111111 1111111 111111111111