NO ./Textures/xpm/star_wars/star_wars_wall_west.xpm
WE ./Textures/xpm/star_wars/star_wars_wall_south.xpm
SO ./Textures/xpm/star_wars/star_wars_wall_north.xpm
EA ./Textures/xpm/star_wars/star_wars_wall_east.xpm

F 220,100,0
C 225,30,0

11111111
10000001
1000N001111111111111
10000001111111111111
11111111111111111111
