C 225,30,0
SO ./path_to_the_south_texture

F 220,100,0
WE ./path_to_the_west_texture
EA ./path_to_the_east_texture


NO ./path_to_the_north_texture

1111111111111111111111111
1000000000110001010110001
1011000001110001010000001
1001000000000000000N00001
1111111111111111111111111
