NO ./Textures/xpm/star_wars/star_wars_wall_west.xpm
WE ./Textures/xpm/star_wars/star_wars_wall_south.xpm
SO ./Textures/xpm/star_wars/star_wars_wall_north.xpm
EA ./Textures/xpm/star_wars/star_wars_wall_east.xpm

F 220,100,0
C 225,30,0

        111111111111111111111111111111111111111111
        100000000011000000000000000000000000000001
        100000000011000000000000000000000000000001
        100000000011000000000010000000000000000001
        100000000011000000000100000D00000000000001
        1D1100000111000000000000000000000000000001
        100100000000000000000000000000000000000001
11111111101100000111000000000000000000000000000001
10000000001100000111D11111111111D11111111111111111
1111011111111101110000001000000000000000000001
1111011111111101110101001000000000000000000001
11000000110101011100000010000000D0000000000001
1000000000000000110000001000000000000000000001
1000000000000000110101001000000000000000000001
11000001110101011111011110000000N000000000000111
11110111 1110101 10111101000000000000000000001
11111111 1111111 11111111111111111111111111111
