C 225,30,0
SO ./path_to_the_south_texture

F 220,100,0
WE ./path_to_the_west_texture
EA ./path_to_the_east_texture


NO ./path_to_the_north_texture

11111111
10100001
10100001
10100001
10000001
10000101
1N000001
11111111
