NO ./Textures/xpm/egypt/egypt_wall_north.xpm
WE ./Textures/xpm/egypt/egypt_wall_east.xpm
SO ./Textures/xpm/egypt/egypt_wall_north.xpm
EA ./Textures/xpm/egypt/egypt_wall_east.xpm

F 179,144,96
C 159,228,245

        1111111111111111111111111
        100D000000110000000000001
        1011000001110000000000001
        1001000000D00000000000001
111111111011000001110000000000001
10000000001100000111D111111000111111
1111D111111111D1110000001000000001
1111011111111101110101001000000001
1100000011010101100000001000000001
1000000000000000100101001000000001
1000000000000000D00000001000000001
1000000000000000100101001000000001
1100000111010101101101111N0000000111
11110111 1110101 10111101000000001
11111111 1111111 11111111111111111