C 225,30,0
SO ./path_to_the_south_texture

F 220,100,0
WE ./path_to_the_west_texture
EA ./path_to_the_east_texture

NO ./path_to_the_north_texture


        1111111111111111111111111
        1000000000110001010110001
        1011000001110001010000001
        1001000000000000000000001
111111111011000001110000000000001
100000000011000001110111111111111
11110111111111011100000010001
11110111111111011101010010001
11000000110101011100000010001
100000000000000011000000001
10000000000000001110010010001
11000001110101011 11011010N0111
11110111 1110101  11111010001
11111111 1111111 111111111111





