SO ./file
WE ./file
EA ./file

F 179,144,96
C 159,228,245

111
1011111
1001001
1010011
1000N01
1110001
  11111